" - ორმაგი ბრჭყალი
' - ერთმაგი ბრჭყალი
syntax - კოდის წერის წესები
error - შეცდომა
parentheses - ფრჩხილები
( - გამხსნელი ფრჩხილი
) - დამხურავი ფრჩხილი
quotation marks - ბრჭყალები
define - შექმნა

src - source - წყარო
interactivity - ვებსაიტის ფუნქციონალი, დავალებები

variable - ცვლადი
variable name - ცვლადის სახელი
variable value - ცვლადის მნიშვნელობა
equal sign - ტოლობის ნიშანი
data type - მონაცემთა ტიპი
statement - წინადადება

ატრიბუტი - დამატებითი ინფორმაცია თეგის შესახებ
heading - სათაური
request - მოთხოვნა
URL - მისამართი, წყარო
bug - შეცდომა
debugging - შეცდომების, error-ების გამოსწორება
embed - ჩასმა, ჩანერგვა




container ელემენტი შეიცავს გამხსნელ და დამხურავ თეგებს ხოლო  empty ელემენტს მხოლოდ გააჩნია გამხსნელი თეგი


puthon: #
html : <!--  -->
java: //
javascript:
//(for single line)
/**/ (for multiple lines)
c++: //(for single line)
/**/ (for multiple lines)